

          NO           ./path_to_the_north_texture


SO ./path_to_the_south_texture
WE ./path_to_the_west_texture
EA ./path_to_the_east_texture

F      220,222,222
C 225,30,1


1111111111111                  11111111111111111
100000000011000               0000000001    
101100000111000              0000000001
1001000000000000            000000001
111111111011000001110000000000001
100000000011000001110111111111111
11110111111111011100000010001
11110111111111011101010010001
11000000110101011100000010001
10000000000000001100000010001
10000000000000001101010010001
11000001111111011111011110N0111
11110111   1110101 101111010001
  111111    1111111 111111111111





	      
	