

          NO           ./path_to_the_north_texture


SO ./path_to_the_south_texture
WE ./path_to_the_west_texture
EA ./path_to_the_east_texture

F      220,222,222
C 225,30,1


11111111111111111111111111111
10000000001100000000000000001    
101100000111000000000000000000011
100100000000000000000000100000001
111111111011000001110000000000001
100000000011000001110111111111111
11110111111011100000010001
1111011111111        1101010010001
1100000011010101     1100000010001
10000000000000001   100000010001
1000000000000   0001101010010001
11000001111111011     111011110N0111
11110111   1110101 101      111010001
  111111    1111111 11      1111111111





	      
	