

          NO           ./path_to_the_north_texture


SO ./path_to_the_south_texture
WE ./path_to_the_west_texture
EA ./path_to_the_east_texture

F      220,222,222
C 225,30,1


1111111111111111111111111111111111
1000000000000000000000000000000001
1000000000000000000000000000000001
1000000000000000000000000000000001
1000000000000000000000000000000001
1000000000000000000000000000000001
10000000000000000N0000000000000001
1000000000000000000000000000000001
1000000000000000000000000000000001
1000000000000000000000000000000001
1000000000000010000000000000000001
1000000000000010000000000000000001
1000000000000010000000000000000001
1000000000000010000000000000000001
1000000000000010000000000000000001
1000000000000010000000000000000001
1000000000000010000000000000000001
1000000000000010000000000000000001
1000000000000010000000000000000001
1000000000000010000000000000000001
1000000000000010000000000000000001
1111111111111111111111111111111111


