

EA ./path_to_the_east_texture



          NO          ./path_to_the_north_texture


SO ./path_to_the_south_texture
F 225,255,0
WE ./path_to_the_west_texture



C 225,255,10



111111111111111111           1111
100001000000000001           10001
100000000000000101           10001
100001000000000001           10001
100010000001000001           10001
1000110000000000011          10001
10001100100000000001         10001
10001100000000000001       110001 
10001111111111111101     1100011  
10001            101111 100011 
1001  1       11100000010001  
101  101    11000000000000111
101   1    10000000000000001
101       1000000000000000001     
101111111100000000000000000001    
100000000000000000010000000001    
111111111100000000000000000001    
          100000000000S000001
           10000000000000001
            110000000000011
              111000001111
               1111111

